Structure [idcode]	Smiles	
ffc@P@@JbgHhlhheEhdi]IUoAruTa@@TU@@@	CCOc1c(cc(c2c3c(CCC(C)=O)c[o]2)O)c3ccc1	
fn}pQ@NFrRwd`qIQFQQQZIQZI[QELEAAETsSU@@@	CCCCCC(N(C=O)c(c(O)c(cc1Cl)Br)c1NC(N)=O)=O	
fo@X@@HEKrR}Fn{|bfbbbbJRrbfLrfTMYj`X`jfZZZX@@	CCc(cc1C(CC(OC(CC(O)=O)=O)=O)=O)c(C(C(O)=O)C(O)=O)cc1OC(C)=O	
e`\XA@@K`DNIMLjolbbTTTTttLTTRberY`QVwQrssTCQ@@DPPAd@@@@	N#Cc(cc(cc1cc2)O)c1c(C(OC(c(c(O)cc1cccc(O)c11)c1O)=O)=O)c2O	
fas`q@KDddm^`bORFQQQZZIJKKQSE`mN``BBbifd@@@	COc(c(NC(CC=O)=O)c(C(O)=O)c(F)c1cc2)c1c(O)c2Cl	
few@p@@Hlfk\bfbbTTRbbLtJHcZ}GHym@@@PQ@p@@@@	OC(c1cc2ccccc2c2cc(O)c(cc(cc3C(O)=O)O)c3c12)=O	
ek`PB@@@DFcdfyefUUgy~QIHjlbaef`HJ`f@hHhP`x`@	CCc(c1ccc23)c([C@H]4C=CC(C)=CC4)c(C(O)=O)cc1c2c(O)c(C)cc3O	
fmwI@@DeFlFRJYIJJJIIYPiI^SFoQuKT@D@TSLDAFDb@	Cc1c(/C=C\C(/OC)=C\Cc(cc2)cc3c2[nH]c(N)n3)cc(CC=C)nc1	
eo`\NH@MDmhbjnikg`HcHhhdeELemBieMMMACG@jP`B@aiiji`PFRr`P`	N[C@@H]([C@H](C(OC(NC(Nc1cccc(/C(\Cl)=C\c2ccccc2)c1)=O)=O)=O)O)C(O)=O	
ehR\J@@DDf`ACKKlbbTbbjbJbbRfVfTRJzjZfV^~ZjfijBBajjhe`vP@	CC(C)(CC(O)=O)C(NC(CCCc1c2[nH]c3c([C@@H](C=CC4)OC)c4c[n]3c2ccc1)=O)=O	
eodPA@@@DNBnekglbfTTRTRRRReRrfTdtTLbrRjZ``b@@Hjjf@HIh@@	O[C@H](CCOc(c1c(cc2)[o]c3c1c1ccccc1cc3CC(O)=O)c2O)CC(O)=O	
fegAp@@HYhoQyEMEELeCDhmDlaJsTkV``bhHbFhJDd@	CC[C@@H](c(cc1O)c(cc(C)[o]2)c2c1O)c(c(C(O)=O)c(cc1)O)c1O	
fdup@@@TteLkZrjxirSh~CKUTREDC@b@@	C(c1c([C@H]2c3ccc[nH]3)nc[nH]1)c1c2cccc1	
fcoAP@@HXwnQSQQIQIIIQPsQDR`yWmhHHjjjAb@RCd@	CCCOc(c(Cc1c(C)cccc1)c([C@@H](C=CC1)C(O)=O)c1c1)c1C(O)=O	
eh\TJH@IgcKHlk`HcHhheEiheeMKDeMMEfAODaehBH`XJF@Hij@@@@	CCN(C(NC)=O)c1cccc(C(OC(Cc(c(-c2cc(O)ccc2)ccc2)c2Cl)=O)=O)c1	
eghXF@@N@DGNaclbfTTTtrbbtRTRROD`VSVrusTuLE@P@pDP@@@	OC(CCc1c[nH]c(-c(c2cc(O)ccc2c2ccccc22)c2O)c1CC(O)=O)=O	
fak`R@NlTyhICHhihihiXmLhiKPXe{RDQ@P@E@@@@	Cc(cnc(O)c1cc2)c1c(O)c2-c(c(C(F)=C)c1O)ccc1O	
fisaJ@OPQQVgAzL@QddabRTvTTjRR`iKTuMSMUSH@@	NC(c1c[o]c(S(CC(OC(CCCCCC(O)=O)=O)=O)(=O)=O)c1)=O	
flyIp@K^CDBJ\dhvQQJJZXsJIQRuTsSSTpq@@	O[C@@H](C(O)=O)C(OC(CC(Nc1nnc[nH]1)=O)=O)=O	
fcQA@FMLBHSHYEEDhmEBUEEdeiJLdjsbuiBHJjB@jjaHBP@	CC(C)(C)Nc(c(C)c1)cc(C(Cc(c2c34)ccc3[nH]cc4Cl)=C[C@H]2O)c1F	
fasPp@DX@ZNV}rJIJIQJJIYPjZ|DkUA@TATSA@T@@	COc(cc(c1ccc2)NC(NC[C@H](CC(O)=O)O)=O)cc1c2O	
e`RXF@@L@DKJmclbbRbbbTRbatRTlrIdWaRSPtswsU@ADDRSMMTELDr@@	OC(c(cc1)c(C(O)=CC2=C[C@H](CC=CC3)C3=C22)c2c1OC(Nc(cccc1)c1O)=O)=O	
ffca@@@`rQQQQIJJIDfRMjKdt@@@APS@@@@	CC(Nc1cc2cccc(C)c2c(Oc2ccccc2)c1)=C	
elRPA@@@DKHmchT\bfbbbbtTvrTVbTTsTDtL|Z@B@hijjiji`PdeT`b`	CC(C)[C@@H](C)/C(\CCCC(O)=O)=C/[C@@H](c1c(C(O)=O)c2cc(OC)cc(CCC(O)=O)c2cc1)O	
fbmq`@BFRABdfyUYe}f\uZNVihHb@`@@@	COc(c1cccc(N)c11)c2[nH]c(C(O)=O)cc2c1N	
eg`XN@@J@D@aicklbbTRVffbbVVfbJdfc`VUSTDDREADmSD@PMH	CCOC(c1nc(-c2c(C/C(\C(O)=O)=C\CC(O)=O)[o]c3c2cccc3)ccc1)=O	
fkwPZ@NM`cAFN}dmYkAxYIIcLhheEDYiTieZKUMUTuSMSUDDiPrm@@	CCOC(CNC([C@H](C[C@H]([C@@H]1C(O)=O)C(O)=O)C[C@@H]1NC(OP(O)(O)=O)=O)=O)=O	
e`TPA@@@DDjfagolbfbRbRRfbTTWbRrg@acbVSP@DDUSMSSLEAYDAgZ@	C/C=C(\C[C@@H](Cc1cc(C(O)=O)cc2ccc3[o]cc(C)c3c12)C(O)=O)/O/C=C/C(O)=O	
ffs``@I@JeLkoLsNvJ\EYrZtBATCDTQ@@@	CCc([n](c1c2C)-c3cc([o]cc4)c4cc3)cc1ccc2O	
eg`XB@@F@DMBlbfRRbTVRTVTtRbIe`TTrsUUSTmU@PUTX\JRAH@	CCc1cccc([C@@H]2C=C([C@@H]([C@@H](C=C3)NCCCC(O)=O)O)C3=C(CO)C2)c1CC	
fdeP`@DF@KHdhdhdeBerQkAbt@QT@A@@@	COc1c2[nH]c(cccc3)c3c2cc(NC=O)c1	
fi{q`@LZjACDfUgWYVumCDk^cZijj@@BJA@@	CCCNC(OC(CCNc1cc2ccc(cc[nH]3)c3c2cc1)=O)=O	
ehRPF@@@GONielbbbTTRbafabLTVJVXTdLZFn^ZBHhfBbHZjjBPXer@@	CC[C@@H]1Cc2cc([C@H](Cc3ccc(C(C)C)c(C(O)=O)c33)CC3=O)c(C(O)=O)c(O)c2CC1	
ek`XBH@ImO@d`HcHhheELlULihheDVNICAimch@@JJZX@@@@@@@	Oc(c1cccc(CCC(OC(c2ccnc3ccccc23)=O)=O)c11)ccc1Cl	
eodPI@@@DIMBiekglbfTTTTTjrbbTrflT\l|RjzvZ`BH@jjjjfBV@eDdeeJdt`@	O[C@@H]([C@@H]([C@H]([C@H](CC(O)=O)C=C1)c(c2c3)c(ccc(O)c4CC(O)=O)c4c3O)[C@@H]1O)[C@H]2O	
elVPJD@@behTPH`ZPrJJIIIQJJKJYJVUIIQcbqqIjjZZj`dIjijZifBlOHeLi@}@	O[C@@H](CC[C@@H]1F)c2c1ccc(C1)c2CC(CC(C(C=C2)=O)=C[C@@H]2C(CCC/C=C/C(O)=O)=O)=C1Cl	
fncaP@I@QZk\bfbbTTlRQRTDktV`H`HHjX@PY@	COc(cc(CCC(O)=O)cc1)c1-c(c(N)ccc1)c1C(O)=O	
fikqb@LAbVoPAFRJKIQJIISUSJXi[uLtDQETtt@@@	CC(OC(CCCCc1c[s]c(Cc2c(C(N)N)cccc2)n1)=O)=O	
fikQp@DTApLV}GdTRbbTrRTRbIdeIruRuTDpUL@@@	Cc1cc(O)cc2c1c(CCC(O)=O)c(C(NC(CC(O)=O)=O)=O)[nH]2	
fmw`q@D\Sd\u`qNaFQQJKZJIQSQMIRDiZHRtuT@D@qTl`@@	OC(c1c(c(Cc(cc([nH]2)O)c2Br)ccc2)c2cc(CCS(O)(=O)=O)c1)=O	
e`XXF@@L@DNOGolbbRTTtTRRbvRrRQdUQSSUST@PDAUULDCB@@	CCc1cc(CCCC(O)=O)c([C@H](CO)COC(NC(c2ccccc2)=O)=O)cc1CC	
fe{ap@B`QhLT}rJZJIKJZJJJERbeT[PDCTCQED@HR`	COc(c(OC)c1/C(\C(O)=O)=C/c(cc(cc2)O)c2C(O)=O)ccc1N	
fasa`@J@t{IEMDeMDlhdjiqTcUPHTUUUUFHITm@@	CCc(c([C@H](C)CCC(C)C)c([C@@H](C=C[C@@H]1OC)OC)c1n1)c1O	
fns@b@JmAHYEEDhhddmLUhse`~S@P@P@Ps@@@@	Cc1cc(F)c(-c(cc2)ccc2C(O)=O)c2cccc(C=C)c12	
ebVXA@@I@DKGNahT\bfbbTTVRRTrTrJRRTPbdf`QSPDPEATTuUUMD@@@	CCCCCCCOc(c(OCCCCCC(O)=O)c1)c2[nH]c(c(C(O)=O)ccc3)c3c2c1C(O)=O	
ekhXJ@@H@NCOCldRbTQRTtTtRRRRphdTbrZfFviB`JBBB`hhD@`TP	Cc(c1c(c(O)c2)-c(c(CC(C)=CC3)c3c(c3c4)ccc4O)c3O)n[o]c1c2O	
eo`XNH@DbMCKGOE`ICHhhheDlijheDhidfIMkhHJJijjjZjapbVTZTGT@	CCN[C@@H](COCc(c(F)c(c(C(O)=O)c1O)OC)c1O)[C@H]([C@@H](C=CC1)OC)/C\1=C/C	
fegQP@JR@cakYEDhileECDhmDTejt\vjfjZ``@BAFEj@@	N[C@H](CN[C@H](CC1)c2cccc3cccc1c23)C(OC(CC(O)=O)=O)=O	
fn}QB@EZjBPRYeeuUWUYr@`jjiZf@PB`	CCCCCCCc(c(CN/C=C\C=O)cc(NC=C)c1)c1F	
fbmA`@@HEdTtRTQbbTQyKpTyZ@H`HJ`P@@	OC(c1cc(O)cc(-c2c(CC=CC3)c3ccc2)c1)=O	
e`TXAH@EBKGOIego`ICHhhdedeEKDeDeDiXpHUUm]MSTtu@ATuSPhFHZPRH	COC(C/C(\C(CC(O)=O)=C1)=N\[C@@H](c2cc(C(O)=O)c([C@H](C=CC3)C(O)=O)c3c2)O)=C1F	
fmw@p@@HDVl|bbRbbbrbvRbQrLxJ^cZhFHbjF@h@@@	COc1cc(Cc2cccc(OC(CC(CCC(O)=O)=O)=O)c2C2)c2cc1	
fdi`r@MPQ`d``|DjmyewTsfj`XHjH@`@	CCCCC(O[P@](O)(Oc(cc1)cnc1O)=O)=O	
fjmaP@A@QYITfUvVY]fc@yZfZ`XJJ@PX`	CCC(N/C(\c1cc(O)cc(O)c1)=C(\CO1)/C=CC1=O)=O	
flu@`@@IrQQ[QQJJZGEMV\FfX@@Hj@@@	Cc1c(cccc2Cc3ccc[o]3)c2c(CO)cc1	
fakpQ@BZ]xK^`qIAFQQQJJIQJQKkQbcNsVBBhFU`ab@@@	Cc1cnc[n]1-c(c(Br)cc1ncccc11)c1S(CC(O)=O)(=O)=O	
eohTJL@E@aIMOI`Jp`HXbLbbbbdTZtJbbTVVRxLzfvN`bEhijiP`JH`bP@	Cc(c(C)c1)cc2c1[o]cc2[C@H](C=C)NC(NS(c(c(OC)ccc1Cl)c1I)(=O)=O)=O	
edVXJH@HRAMo`PICHhhihdmiheEBdeMeDqIiXeeUuL]A@PD@PUTttv@tDT@@	N#CC(C=C[C@@H]1C2=C(CC(O)=O)Cc3cccc(Oc4cc5ccccc5c(F)c4O)c13)=C2O	
fjeaj@BPQcdeV]{IPAFRREJJ[JJUJKULuLuL@@	OC(CCC(OC(NS(OC(CC(O)=O)=O)(=O)=O)=O)=O)=O	
fe{`R@BFmxHHcHhhdhdieBYEBdrPyuSUTtuT@DH`fH@	CC(C)(CC[C@H](C[C@@H]1Cl)CC(C(O)=O)=C1NCC(O)=O)c1ccccc1	
ffma`@C@QEImUVYU]wAZjZBBJj@PX`	CCCCNc(cc1)c(C/C=C\CCCC(O)=O)cc1OC	
faka`@L@PwHihhdeEDThibjtZiJuSUUPIEQBIJj@@	CC(C)CN(C(O)=O)C(C1)=C[C@@H](C=C[C@H](C)c2c3)c2c1c(C)c3O	
ekhPHH@F`ICHheEEDliDmDlhjfNMKHdjiemijjZjj`ZHJjALDPfEqEEhdeL`@	C[C@@H](C[C@H]1CC=C2[C@@](CO)(C=C[C@@H]3C)c4c3cccc4)C[C@@H]3[C@H]1[C@@H]2C(F)=C[C@H]3C	
fcopR@KYfyoQ`bLbbRRTRVaRTRbeUFRu[uKTaADuSMUBJIL`F@	CCNC(N[C@H](/C=C/c(ncc1c2CC=C3C=CC(Cl)=C[C@@H]13)c2O)C(O)=O)=O	
eghTL@@Fa`DElbfRbbTRVTRbbbfzaegaVsPsU@@AAHSUE@P@@	CCc(cc1C)c(cc(c(CCC(O)=O)cc(-c2c(C)[nH]nc2C)c2)c2c2)c2c1O	
fj}A`@@HudTtTRbaVTrPiFmdkPDEUP@BPx`@	CC(Cc1cccc(C(O)=O)c11)=C[C@H]1Oc1ccccc1	
ebVTIH@LGhDAIOHf`XP@cIIBhhhieDeHiltehhdXEMlcbmPLQTITpQTmPH@@	CC(C)(C)c(c1cc(-c2ccc[nH]2)ccc1c(O)c1C=O)c1S(NC(OC(CCC(O)=O)=O)=O)(=O)=O	
fj}A@@@YEEEEEEMDe\ip\iKTE@U@TPRHSB@@	CC(C)[C@H](C)[C@H](c1c(CCCC2)c2cc2ccccc12)O	
fj}aB@@jADILkZsjj|mN}ELt`D@EU@`aB@	CCc1c[nH]c2c1cc1c(O)cc(/C=C(\C=C)/Cl)cc1c2	
eodPLH@Bik`ICHhheBhdmMDhceLdfNECG@lfhBBjjBAafjab@RPMP	Cc(c([C@H](CCc1cccc(C(/C=C/C(CCCOC)=O)=O)c11)C1=CC1)c1cc1)c1F	
fluP@@@IrQSQJJ[IJWdeF\F`@@bjhJEh@	Cc1c([C@H](CN)CCC2)c2c2c(NC)cccc2c1	
fikPR@IAKWhpRBSJwrlls[TYel@EUPTPppPE@@	Cc1c([C@H](CCC(O)=O)Nc(c(C(O)=O)ccc2)c2N)ccc(F)c1	
fdy`P@F@QJJS\msZ{jw`mUa@@DDLP@	N#C[C@H](C(O)=O)c(c1cc(O)ccc1cc1)c1O	
fcAP@@Qjt^RJJIJISQEQEQJhQm^BdoZB`AHbJjjbGBEzY`@	CCCOc1c([C@H](C=C([C@@H]2C=C[C@@H]3Oc4cc(CO)ccc4)O)O)c2c3cc1	
fle`P@O@IINQQQSIPzIKLDFLDDUP@PPy@@	C[C@H](Cc(cc1)cnc1O)c(c(O)c(cc1)O)c1O	
ehTTIHDODbGLbfnco`PHaJ^nrJJIJKSJJHjJKEZYQbSpJBBbYijijiib`bdAd@	CCOc([nH]1)c([C@H](CCC(CC(O)=O)=O)O)c(-c2cc(/C=C/[N+]([O-])=O)cc(Cl)c2OC)c1O	
edRPJL@Emck`PIABPpdLbdJbTRTRVRtfbbbSdf`RWtMUMUEAEU@sA@BGDTP@	CCC[C@H](C)[C@@H](C(CC(F)(F)F)=CC1)c2c1ccc(C(C(O)=O)(C(O)=O)c1cc(O)ccc1)c2	
eohTN@@LE@DHnmkglbfRRbbbRTTtLTvTL|RjVNZf``hjBhaFDPl`T`H`	O[C@@H](C=C[C@H]1C=O)c2c1ccc(Nc(c(C(O)=O)ccc1)c1O)c2C/C=C/NC(O)=O	
el^PFH@NM@chTP@cIEELUEEDhddeCEdcMLJKHlnamg`ZYjB@hBh`XHZBHAd@@	CCOc(c(Oc1cc(C(O)=O)ccc1)c(C=C[C@@H]1O)c2c1cccc21)c1OCc1ccc(C)[s]1	
fcgPP@DQ@pPTfUf~UYv]Y|ejfZABbjjhA@t@	CCCN(CC)/C(\OC)=C\CC(NC(CC(c1ccc(C(C)C)cc1)=O)=O)=O	
ec`TL@@Dn`NIldTTTTRRRUbtRTTcadPVWPrvu@D@D@QULhE@@@	COc(ccc(c1cc2c3[nH]cc2)c3-[n]2c(O)ccc2)c1Oc1ccccc1	
fleA`@@FmdTTRRTVbLSA^BtsTC@U@HXP	Cc(cc1C)cc(/C=C(/CC(C(C)=C2)=O)\C2=O)c1O	
edV\N@DH@`PDAiechXIP{HihdidhdheDiidiXUpIhXdUTu]|t@@AAIESUU\@jGRvP@	N#C[C@@H](c(c1c(-c2c(ccc([N+]([O-])=O)c3)c3cc3cccc(C(O)=O)c23)[nH]2)c2O)C(O)=C[C@H]1O	
fbm@C@@UaiBtadTTRbVtebRYrVdy`@@bh@@@@@	FC(c1ccccc1)(c1cc2ccccc2c(I)c1)F	
fg@P@@HO_HidhheDmiMBeMdhkUoMT@@DUUUULB@jj@@	CC[C@@H](C[C@@H](C)CCCC(O)=O)C(C)(C)c1cc2ccccc2c(CCC(O)=O)c1	
fi{Pp@NI@a`kQrJZJJ[QJKQQUHITyzMjfZiYijVkFIIE`@	OC([C@H](C([C@@H](C=C1C=CC=C[C@H]1c1c[nH]2)c1c2O)=O)C(NC=O)=O)=O	
facPp@CI@bW`qrJZJIQKPqS[RBttDCESMUQAR@@	CC(C)(C)NC([C@H](C(c(ccc(N)c1)c1C(O)=O)=O)C(OC)=O)=O	
fjm@R@BFlDDadTTVfbTQtrSAZ]A@DCDuP@@@	CCCCC(OC(c(cccc1cc2)c1c(O)c2F)=O)=O	
fjma`@K@PqInYVvWWEktV```hHj@@@	CCCCOc(c(c(cc1)c(CC)cc2)c2N)c1C(O)=O	
fkwQ`@LV@bNQQIQJIJYJiQQIRCfuSULuU@PU@LTUQh	CCCCNC(O\C(/C=C/C)=C(\C)/C(\C)=N/OCc1c(C(C)(C)C)cccc1)=O	
fasAP@@HtUnQSQIYJISIPiS`hiZ@BZ`@jX@Pe@	CC(OCc1cccc(/C(\OC)=C\c(cc2)ccc2C(O)=O)c1)=O	
e`XXED@LHDNAIKNmgo`@`rPrRPsQSYPqQJKJYHjYEMCKULuL@@DULp@P[P	COc(c1c2/C=C/C(O)=O)ccc(C(OC(N(C(CF)=O)S(C)(=O)=O)=O)=O)c1ccc2O	
ffcQ@@IIAdTTRbcdTJTvYpThyiffj`BIX@@	CC(C)(c1c2c(O)cccc2c[nH]1)c1cc(NC=C)ccc1	
fle@P@@HbeInYYgmaRtyhBBjjXT\bd@	CC[C@H](C=C[C@H](C)c1cc(C(O)=O)c2)c1c2C(O)=O	
e`P\IH@KHlbFCG@ncgo`IAIf[gYfUeu[`RBHJfYjjZif@@@	CCCNCC(Oc1cc(C(NC(CC(O)=O)=O)=O)c(C(NCCC=O)=O)c(O)c1F)=O	
eohXF@@N@DFOJalbfbbrRTtRQTfbfLDdL\brZZjZBBJjjjhpdaRZ`@	CC(C)C[C@@H]([C@](C(C)C)(c1cc(OC)c([C@H](C(C2)=CC3)NC(O)=C2C(O)=O)c3c1)O)O	
fmo`P@F`xGnQQQJJIKISPqIHlUJwlsVtCATRtapDQAT@@	N#CC([C@H](C(C=C1)=C2)c3cccc(OC(c4ccccc4)=O)c3C2=O)=C1O	
fk@p@@HlvZ|bbTrTVRRbbbRTLEJkQ{Z`@ijdI`Xb@Pt`	Cc1cccc(OCc2cc(C(OC)=O)cc(/C=C\c3c[o]cc3C(O)=O)c2)c1	
e`TTBH@FBljfi`HcHhhhhhceMEEKmMDepHiX}}@D@TSMSTp@@@PNP	CC(Cc(cccc1cc2)c1c(Cl)c2N/C(\C(OC(c1ccccc1)=O)=O)=C(\NC)/O)=C	
ehZPL@@@DFlbfbbTRRrfTrbRVaRDdt\|bFv~AZ@@@@bB`hjh@`@@	COc(cccc1)c1-c1c2c3ccccc3c(C(O)=O)cc2cc(CCC2CCCCC2)c1	
